Key	Japanese	English	Korean
Yes	はい	Yes	네
No	いいえ	No	아니오
Ok	OK	OK	확인
Cancel	キャンセル	Cancel	취소
Back	もどる	Back	뒤로
Clear	クリア	Clear	클리어
Retry	リトライ	Retry	재시도
History	履歴	History	역사
Save	セーブ	Save	세이브
Load	ロード	Load	로드
On	オン	On	켜기
Off	オフ	Off	끄기
Skip	スキップ	Skip	스킵
None	なし	None	없음
Sound	サウンド	Sound	사운드
Review	レビュー	Review	리뷰
Restore	リストア	Restore	복원하다
Download	ダウンロード	Download	다운로드
QuitGame	ゲームを終了しますか？	Quit Game?	게임을 종료하시겠습니까?
DebugInfo	●デバッグ情報	Debug Info	디버그 정보
DebugLog	●デバッグログ	Debug Log	디버그 로그
DebugMenu	●デバッグメニュー	Debug Memu	디버그 메뉴
DeleteSaveAndQuit	セーブ消去＆終了	Delete Save	세이브 삭제
DeleteCacheFile	ｷｬｯｼｭﾌｧｲﾙ削除	Delete Cache	캐시 삭제
Language	言語	Language	언어
DeleteAllSaveDataFilesTitle	「宴」のセーブデータを消去	Delete save data of "Utage"
DeleteAllSaveDataFilesMessage	「宴」のセーブデータを全て消去しますか？		Are you sure you want to clear all saved data of "Utage"?
DeleteAllCacheFilesTitle	「宴」のキャッシュファイルを消去		Delete cache files of "Utage"
DeleteAllCacheFilesMessage	「宴」のキャッシュファイルを全て消去しますか？		Are you sure you want to clear all cache files of "Utage"?
DeleteAllOutputFilesTitle	「宴」の出力ファイルを消去		Delete output files of "Utage"
DeleteAllOutputFilesMessage	「宴」の出力ファイル（セーブデータとキャッシュファイル）を全て消去しますか？		Are you sure you want to clear all (cache file and save data) output file of "Utage"?
Downloading	ダウンロード中です...	Downloading...	다운로드중...
DownloadCount	{0}/{1}	{0}/{1}	{0}/{1}
DownloadFinished	ダウンロード完了！	Download Finished!
WarningNotOnline	ネットワークにつながっていません	Warning! Not Online
WarningNotWifi	サイズの大きいデータがダウンロードされます。Wifi接続ではないですがよろしいですか。	Warning! Not Wifi
ChangeCurrentProject	現在のシナリオプロジェクトファイルを変更します	Change Current Scenario Data Project
VersionUpScene	宴のシーンをバージョンアップする必要があります。よろしいですか	Current UTAGE scene should be upgraded. Is it OK？
VersionUpScenario	宴のシナリオを再インポートしてバージョンアップする必要があります。よろしいですか	Current UTAGE Scenario should be upgraded. Is it OK？
Redownload	再ﾀﾞｳﾝﾛｰﾄﾞ	Redownload	재다운로드

